8 8 8 8 8 8 8 8 8 8 8 8 8 8 8 8 8 8 8 8 8 8 8 8 8 12 12 12 12 12 12 12 12 12 12 12 12 12 12 12 12 12 12 12 12 12 12 12 12 12 
8 0 0 0 0 0 0 0 0 0 0 0 0 0 0 0 0 0 0 0 0 0 0 0 0 1 1 1 1 1 1 1 1 1 1 1 1 1 1 1 1 1 1 1 1 1 1 1 1 12 
8 0 0 0 0 0 0 0 0 0 0 0 0 0 0 0 0 0 0 0 0 0 0 0 0 1 1 1 1 1 1 1 1 1 1 1 1 1 1 1 1 1 1 1 1 1 1 1 1 12 
8 0 0 0 0 0 0 0 0 0 0 0 7 50 50 0 0 0 0 0 0 0 0 0 0 1 1 1 1 1 1 1 1 1 1 1 1 1 1 1 1 1 1 1 1 1 1 1 1 12 
8 0 0 0 0 0 0 0 0 0 0 0 50 50 50 0 0 0 0 0 0 0 0 0 0 1 1 1 1 1 1 1 1 1 1 1 1 1 1 1 1 1 1 1 1 1 1 1 1 12 
8 0 0 0 0 0 0 0 0 0 0 0 50 50 50 0 0 0 0 0 0 0 0 0 0 1 1 1 1 1 1 1 1 1 1 2 50 1 1 1 1 1 1 1 1 1 1 1 1 12 
8 0 0 0 0 0 0 0 8 8 8 8 8 8 8 8 8 8 0 0 0 0 0 0 0 1 1 2 50 1 1 1 1 1 1 50 50 1 1 1 1 11 50 1 1 1 1 1 1 12 
8 0 0 3 50 0 0 0 0 0 9 50 0 0 0 0 0 0 0 0 0 0 0 0 0 1 1 50 50 1 1 1 1 1 1 1 1 1 1 1 1 50 50 1 1 1 1 1 1 12 
8 0 0 50 50 0 0 0 0 0 50 50 0 0 0 0 0 0 0 0 0 0 0 0 0 1 1 1 1 1 1 1 12 12 12 12 12 12 12 12 12 12 1 1 1 1 1 1 1 12 
8 0 0 0 0 0 0 0 9 50 0 0 0 0 0 0 0 0 0 0 0 0 0 0 0 1 1 1 1 1 1 1 1 1 1 1 1 12 12 12 12 12 12 12 12 12 12 1 1 12 
8 0 0 0 0 0 0 0 50 50 0 0 0 0 0 0 0 0 0 0 0 0 0 0 0 1 1 1 1 1 1 1 1 1 1 1 1 1 1 1 1 1 1 1 1 1 1 1 1 12 
8 0 8 8 8 8 8 8 8 8 8 8 0 0 0 0 0 0 0 0 0 0 0 0 0 1 1 1 1 94 1 1 1 1 1 1 1 1 1 1 1 1 1 1 1 1 1 1 1 12 
8 0 0 0 0 0 0 0 0 0 92 0 0 0 0 0 7 50 50 0 0 0 0 0 0 1 1 1 1 94 1 1 1 1 1 1 1 1 1 1 1 1 1 1 1 1 1 1 1 12 
8 0 0 0 0 0 0 0 0 0 92 0 0 0 0 0 50 50 50 0 0 0 0 0 0 1 1 1 1 94 1 1 1 1 1 1 1 1 1 1 1 1 2 50 1 1 1 1 1 12 
8 0 0 0 0 0 0 0 0 0 92 0 0 0 0 0 50 50 50 0 0 0 0 0 0 1 1 1 1 94 1 1 1 1 1 1 1 1 1 1 1 1 50 50 1 1 1 1 1 12 
8 0 0 0 0 0 0 0 0 0 92 0 0 0 0 0 0 0 0 0 0 0 0 0 0 1 1 1 1 94 1 1 1 1 1 1 1 1 1 1 1 1 1 1 1 1 1 1 1 12 
8 0 0 0 0 0 0 0 0 0 92 0 0 0 0 0 0 0 0 0 0 0 0 0 0 1 1 1 1 1 1 1 1 1 1 1 1 1 1 1 11 50 1 1 1 1 1 1 1 12 
8 0 0 0 0 0 0 0 0 0 0 0 0 0 0 0 0 0 0 0 0 0 0 0 0 1 1 1 1 1 1 1 1 1 1 1 1 1 1 1 50 50 1 1 1 1 1 1 1 12 
8 0 0 0 0 0 0 0 0 0 0 0 0 0 0 7 50 50 0 0 0 0 0 0 0 1 1 1 1 1 1 1 1 1 1 2 50 1 1 1 1 94 1 1 1 1 1 1 1 12 
8 0 0 0 0 0 0 0 0 0 0 0 0 0 0 50 50 50 0 0 0 0 0 0 0 1 1 1 1 1 1 1 1 1 1 50 50 1 1 1 1 94 1 1 1 1 1 1 1 12 
8 0 0 9 50 0 0 0 0 0 0 0 0 0 0 50 50 50 0 0 0 0 0 0 0 1 1 1 1 1 1 1 1 1 1 1 1 1 1 1 1 94 1 1 1 1 1 1 1 12 
8 0 0 50 50 0 0 0 0 0 0 0 0 0 0 0 0 0 0 0 0 0 0 0 0 1 1 1 1 1 1 1 1 1 1 1 1 1 10 50 50 94 1 1 1 1 1 1 1 12 
8 0 0 0 0 0 0 0 0 0 0 0 0 0 0 0 0 0 0 0 0 0 0 0 0 1 1 1 1 1 1 1 1 1 1 1 1 1 50 50 50 94 1 1 1 1 1 1 1 12 
8 0 0 0 0 0 0 0 0 0 0 0 0 0 0 0 0 0 0 0 0 0 0 0 0 1 1 1 1 1 1 1 1 1 11 50 1 1 50 50 50 1 1 1 1 1 1 1 1 12 
8 0 0 0 0 0 0 0 0 0 0 0 0 0 0 0 0 0 0 0 0 0 0 0 0 1 1 1 1 1 1 1 1 1 50 50 1 1 1 1 1 1 1 1 1 1 1 1 1 12 
8 8 8 8 8 8 8 8 8 8 8 0 0 0 0 0 0 0 0 0 0 0 0 0 0 1 1 1 1 1 1 1 1 1 1 1 1 1 1 1 1 1 1 1 1 1 1 1 1 12 
8 0 0 0 0 0 0 0 0 0 0 0 0 0 0 0 0 0 0 0 0 0 0 0 0 1 1 1 1 1 1 1 1 1 1 1 1 1 1 1 1 1 1 1 1 1 1 1 1 12 
8 0 0 0 0 0 0 0 0 0 0 0 0 0 0 0 0 0 0 0 0 0 0 0 0 1 1 1 1 1 1 1 1 1 1 1 1 1 1 12 12 12 12 12 12 12 12 12 12 12 
8 0 0 0 0 0 0 0 0 0 0 0 0 0 0 0 0 0 0 0 0 0 0 0 0 1 1 1 1 1 1 1 1 1 1 1 1 1 1 1 1 1 1 1 1 1 1 1 1 12 
8 0 0 0 0 0 0 0 0 0 0 0 0 0 0 0 0 9 50 0 0 0 0 3 50 1 1 1 1 1 1 1 1 1 1 1 1 1 1 1 1 1 1 1 1 1 1 1 1 12 
8 0 0 0 0 0 0 0 0 0 0 0 0 0 0 0 0 50 50 0 0 0 0 50 50 1 1 1 1 1 1 1 1 1 1 1 1 1 1 1 1 1 1 1 1 1 1 1 1 12 
8 0 0 0 0 0 0 0 0 0 0 0 0 0 0 0 0 0 3 50 0 0 0 0 0 1 1 1 1 1 1 1 1 1 1 12 12 12 12 12 12 12 12 12 12 1 1 1 1 12 
8 0 0 0 0 0 0 0 0 0 0 0 0 0 0 0 0 0 50 50 0 0 0 0 0 1 1 1 1 1 1 1 1 1 1 1 1 1 1 1 1 1 1 1 1 1 1 1 1 12 
8 0 0 0 0 0 0 0 0 0 0 0 0 0 0 0 0 0 0 0 0 0 0 0 0 1 1 1 1 1 1 1 1 1 1 1 1 1 1 1 1 1 1 1 1 1 1 1 1 12 
8 0 0 0 0 0 0 0 0 0 0 0 0 0 0 0 0 0 0 0 0 0 0 0 0 1 1 1 1 1 1 1 11 50 1 1 1 1 1 1 1 1 1 1 1 1 1 1 1 12 
8 0 0 0 0 0 0 0 0 0 0 0 0 0 0 3 50 0 0 0 0 0 0 0 0 1 1 1 1 1 1 1 50 50 1 1 1 1 1 1 1 1 1 1 1 1 1 1 1 12 
8 0 0 0 0 0 0 0 0 0 0 0 0 0 0 50 50 0 0 0 0 0 0 0 0 1 1 1 1 1 1 1 1 1 1 1 1 1 1 1 1 1 1 1 1 1 1 1 1 12 
8 0 0 0 0 0 0 0 0 0 0 0 0 0 0 0 0 0 0 0 0 0 3 50 0 1 1 1 1 1 1 2 50 1 1 1 10 50 50 1 1 1 1 1 1 1 1 1 1 12 
8 0 0 0 0 0 0 0 0 0 0 0 0 0 0 0 0 0 0 0 0 0 50 50 0 1 1 1 1 1 1 50 50 1 1 1 50 50 50 10 50 50 1 1 1 1 1 1 1 12 
8 0 0 0 0 0 0 0 0 0 0 0 0 0 0 0 0 0 0 7 50 50 0 0 0 1 1 1 1 1 1 1 1 1 1 1 50 50 50 50 50 50 1 1 1 1 1 1 1 12 
8 0 0 0 0 0 0 0 0 0 0 0 0 0 0 0 0 0 0 50 50 50 0 0 0 1 1 1 1 1 1 1 1 1 1 1 1 1 1 50 50 50 1 1 1 1 1 1 1 12 
8 0 0 0 0 0 0 0 0 0 0 0 0 0 0 0 0 0 0 50 50 50 0 0 0 1 1 1 1 1 1 1 1 1 1 1 1 1 1 1 1 1 1 1 1 1 1 1 1 12 
8 0 0 0 0 0 0 0 0 0 0 0 8 8 8 8 8 8 8 8 8 8 0 0 0 1 1 1 1 1 1 10 50 50 1 1 1 1 1 1 1 1 1 1 1 1 1 1 1 12 
8 0 0 0 0 0 0 0 0 0 0 0 0 0 0 9 50 0 0 0 0 0 0 7 50 50 1 1 1 1 1 50 50 50 1 1 1 1 1 93 1 1 1 1 1 1 1 1 1 12 
8 0 0 0 0 0 0 0 0 0 0 0 0 0 0 50 50 0 0 0 0 0 0 50 50 50 1 1 1 1 1 50 50 50 1 1 1 1 1 93 1 1 1 1 1 1 1 1 1 12 
8 0 0 0 0 0 0 0 0 0 0 0 0 0 0 0 0 0 0 0 0 0 0 50 50 50 1 1 1 1 1 1 1 1 1 1 1 1 1 93 1 1 1 1 1 1 1 1 1 12 
8 0 0 0 0 0 0 0 0 0 0 0 0 0 0 0 0 0 0 0 0 0 0 0 0 1 1 1 1 1 1 1 1 1 1 1 1 1 1 93 1 1 1 1 1 1 1 1 1 12 
8 0 0 0 0 0 0 0 0 0 0 0 0 0 0 0 0 0 0 0 0 0 0 0 0 1 11 50 1 1 1 1 1 1 1 1 1 1 1 93 1 1 1 1 1 1 1 1 10 50 
8 0 0 0 0 0 0 0 0 0 0 0 0 0 8 8 8 8 8 8 8 8 8 8 0 1 50 50 1 1 1 1 1 12 12 12 12 12 12 12 12 12 12 1 1 1 1 1 50 50 
8 8 8 8 8 8 8 8 8 8 8 8 8 8 8 8 8 8 8 8 8 8 8 8 8 12 12 12 12 12 12 12 12 12 12 12 12 12 12 12 12 12 12 12 12 12 12 12 50 50 
