0 0 0 0 0 0 0 0 0 0 0 0 0 0 0 1 1 11 1 1 1 1 1 1 1 1 1 1 1 1
0 0 0 4 0 0 0 0 5 0 0 8 0 0 0 1 1 1 1 1 1 1 1 1 1 1 1 1 6 1
0 0 0 0 0 0 0 0 0 0 0 0 0 0 0 1 1 1 1 1 4 1 1 1 1 1 1 1 1 1
0 7 0 0 0 3 0 0 0 0 0 0 5 0 0 1 1 1 1 1 1 2 1 1 1 1 11 1 1 1
0 0 0 0 0 0 0 0 0 0 0 0 0 0 0 1 1 1 1 1 1 1 1 1 6 1 1 1 10 1
0 0 0 4 0 0 0 0 3 0 0 0 0 8 0 1 1 1 1 1 1 1 1 1 1 1 1 1 1 1
0 0 0 0 0 0 0 0 0 0 0 0 0 0 0 1 1 1 1 1 1 1 1 1 2 1 4 1 12 1
0 0 0 0 0 3 0 0 0 0 0 0 0 0 0 1 1 1 1 1 1 1 1 1 1 1 1 1 1 1
0 0 0 0 0 0 0 0 0 4 0 0 0 0 0 1 1 1 1 1 1 1 1 1 1 1 1 1 10 1
0 0 0 7 0 0 0 0 0 0 0 0 0 8 0 1 1 1 1 1 1 1 1 1 1 1 1 1 1 1
0 0 0 0 0 0 0 0 0 3 0 0 0 0 0 1 1 1 1 1 1 1 1 4 1 1 1 1 1 1
0 0 5 0 0 4 0 0 0 0 0 0 9 0 0 12 1 1 1 1 1 1 1 1 1 1 1 1 1 1
0 0 0 0 0 0 0 0 0 0 0 0 0 0 0 1 1 11 1 6 1 1 1 1 2 1 1 1 1 1
0 9 0 0 0 3 0 0 0 0 0 0 0 0 0 1 1 1 1 1 1 1 2 1 1 1 1 1 1 1
0 0 5 0 0 0 0 0 0 7 0 0 0 0 0 1 1 1 1 12 4 1 1 10 1 1 1 1 1 1
0 3 0 0 0 3 9 0 0 0 0 0 0 0 0 1 6 1 1 1 1 1 1 1 1 1 1 1 1 1
  
